#include "pch.h"
#include <iostream>
#include <conio.h>
#include <Windows.h>
#include <stdlib.h>

int main()
{
	printf("Welcome to this game !\n");
	Sleep(2000);
	system("cls");
	Sleep(1000);
	char a[50][50] = { "######",
					   "#O #  ",
					   "# ## #",
					   "#  # #",
					   "##   #",
					   "######",
	};
	int i, x, y, p, q;
	char ch;
	x = 1; y = 1; p = 1; q = 5;
	for (i = 0; i <= 5; i++)
		puts(a[i]);
	while (x != p || y != q)
	{
		ch = _getch();
		if (ch == 's')
		{
			if (a[x + 1][y] != '#')
			{
				a[x][y] = ' ';
				x++;
				a[x][y] = 'O';
			}
		}
		if (ch == 'w')
		{
			if (a[x - 1][y] != '#')
			{
				a[x][y] = ' ';
				x--;
				a[x][y] = 'O';
			}
		}
		if (ch == 'a')
		{
			if (a[x][y - 1] != '#')
			{
				a[x][y] = ' ';
				y--;
				a[x][y] = 'O';
			}
		}
		if (ch == 'd')
		{
			if (a[x][y + 1] != '#')
			{
				a[x][y] = ' ';
				y++;
				a[x][y] = 'O';
			}
		}
		system("cls");
		for (i = 0; i <= 5; i++)
			puts(a[i]);
	}
	system("cls");
	printf("Done!\n");
	Sleep(3000);
	printf("下一关！\n");
	Sleep(2000);
	system("cls");
	char g[50][50] = { "################",
					   "#O ##### #### ##",
					   "## ###    ### ##",
					   "##   # ##   # ##",
					   "## # # ## ###   ",
					   "## # # ##   # ##",
				       "## #   ## # # ##",
					   "## ########   ##",
					   "################",
	};
	int b, n, m, j, k;
	char ee;
	b = 1, n = 1, m = 4, j = 15;
	for (k = 0; k <= 8; k++)
		puts(g[k]);
	while (b != m || n != j)
	{
		ee = _getch();
		if (ee == 's')
		{
			if (g[b + 1][n] != '#')
			{
				g[b][n] = ' ';
				b++;
				g[b][n] = 'O';
			}
		}
		if (ee == 'w')
		{
			if (g[b - 1][n] != '#')
			{
				g[b][n] = ' ';
				b--;
				g[b][n] = 'O';
			}
		}
		if (ee == 'a')
		{
			if (g[b][n - 1] != '#')
			{
				g[b][n] = ' ';
				n--;
				g[b][n] = 'O';
			}
		}
		if (ee == 'd')
		{
			if (g[b][n + 1] != '#')
			{
				g[b][n] = ' ';
				n++;
				g[b][n] = 'O';
			}
		}
		system("cls");
		for (k = 0; k <= 8; k++)
		{
			puts(g[k]);
		}
	}
	system("cls");
	printf("Done\n");
	Sleep(2000);
	printf("下一关！\n");
	Sleep(1000);
	system("cls");
	char z[50][50] = { "############################################",
					   "#O################         #          #     ",
					   "# ####             ####### #  # ##### # # ##",
					   "# #### ### #  ############ #  #     # # ## #",
					   "#   ## ##          ####### #  # ##### # ## #",
					   "### ## ## ###    ## ###    #  #     # # ## #",
					   "### ## ## ######### ### ####### ##### # ## #",
					   "### ## #  #   #     ### ##      ### # # ## #",
					   "### ## # # # #  ####### ## ####     # # ## #",
					   "### ## # ##     ##    # ## ########## # ## #",
					   "### ## # #  # #    ## # ##     # #    # ## #",
					   "### ##   # ## ####### # ###### # # # ## ## #",
					   "### ###### ## ###     #    # # # # # #  ## #",
					   "###        ## ### ######## # # # # # # ### #",
					   "############# ### ##   ### # # # # # # # # #",
					   "############# ### ## # ### # # # # # # # # #",
					   "#    #        ###    # ### # # # # # # # # #",
					   "# # ## ############### ### # # # # # #     #",
					   "# # ## ##########    # ### # # # # # ##### #",
					   "# # ## #          ## # ###     # # ##    # #",
					   "# # ## ###### #### # # ######### # ## ## # #",
					   "# # ##    ### #### # # ##          ## ## # #",
					   "# # ##### ###    # # # ## ########### ## # #",
					   "##        ###### # # # ## #######     ## # #",
					   "######### ###### # # # ## ######  ###### # #",
					   "##        ###### # # # ## #####        # # #",
					   "## ### ####      # # # ## ####  ###### # # #",
					   "## ### ######### # # # ##  ##  ####### #   #",
					   "## ###  ###      # # # ### ###   ######### #",
					   "## #### ### ### ## # # ###  ####        ## #",
					   "## ####  ## ###  # #   ####  ## ####### ## #",
					   "##    ## ## ###### #########  #         ## #",
					   "##### ## ##         ##     ##  ####  ## ## #",
					   "##### ############# ## ### ###  ###  ## ## #",
					   "##### ##          # ## # # ####  ### ## ## #",
					   "##### ## #   # #### ## # #    ##  ##  # ## #",
					   "##### ## ##  # #### ## # #### ###  ## # ## #",
					   "##### ## ### # #### ## # #### ####  # # ## #",
					   "##    ## ### #      ## #    # #####  ## ## #",
					   "## ##### #######   ### # ####        ## ## #",
					   "## #####      #### ### # ############## ## #",
					   "## ########## #### ### #   #   ##       ## #",
					   "##        ### ####  ##   #   # #  ######## #",
					   "#########     #####  #########   #         #",
					   "############################################",
	};
	int e, t, f, v, c;
	char rr;
	e = 1, t = 1, f = 1, v = 43;
	for (c = 0; c <= 44; c++)
	{
		puts(z[c]);
	}
	while (e != f || t != v)
	{
		rr = _getch();
		if (rr == 's')
		{
			if (z[e + 1][t] != '#')
			{
				z[e][t] = ' ';
				e++;
				z[e][t] = 'O';
			}
		}
		if (rr == 'w')
		{
			if (z[e - 1][t] != '#')
			{
				z[e][t] = ' ';
				e--;
				z[e][t] = 'O';
			}
		}
		if (rr == 'a')
		{
			if (z[e][t - 1] != '#')
			{
				z[e][t] = ' ';
				t--;
				z[e][t] = 'O';
			}
		}
		if (rr == 'd')
		{
			if (z[e][t + 1] != '#')
			{
				z[e][t] = ' ';
				t++;
				z[e][t] = 'O';
			}
		}
		system("cls");
		for (c = 0; c <= 44; c++)
		{
			puts(z[c]);
		}
	}
	system("cls");
	printf("Done!\n");
	system("pause");
}
